L,L,L,L,L,L,L,L,L,L,O,O,L,L,L,L,L,L,L,L,L
L,L,L,L,L,L,L,L,L,L,L,O,O,L,L,L,L,L,L,L,L
L,L,L,L,L,L,L,L,O,L,L,L,L,L,L,L,O,O,O,O,L
L,L,L,L,L,L,L,L,O,L,L,L,L,L,L,L,O,L,L,L,L
L,L,L,L,L,O,L,L,O,L,L,L,L,O,L,L,O,L,L,L,L
L,L,L,L,L,L,L,L,O,L,L,L,O,O,O,L,O,O,O,L,L
L,L,L,O,L,L,L,L,O,L,L,L,L,O,L,L,O,L,L,L,L
L,L,O,O,O,L,L,L,O,O,O,O,L,L,L,L,O,O,O,O,L
L,L,O,O,O,L,L,L,L,L,L,L,L,L,L,L,L,L,L,L,L
L,L,O,O,O,L,L,L,L,L,L,L,L,L,L,L,L,L,L,L,S
L,L,O,O,O,L,L,L,L,L,L,L,L,L,L,L,L,L,L,L,L
L,L,O,O,O,L,L,L,L,L,L,L,L,L,L,L,L,L,L,L,L
L,O,O,O,O,O,L,L,L,L,L,L,L,L,L,L,L,O,L,L,L
O,O,O,O,O,O,O,L,L,L,L,L,L,L,L,L,L,O,O,O,O
O,O,O,O,O,O,O,L,L,L,L,L,L,L,L,L,L,L,L,L,L